222222222222222222222222
210000020222220000000222
200022000200002222000222
200220002000000000000002
200000000000002000000002
222220000002222222002222
200002222222222000000022
200002220000002000002002
200022222200000000000002
200000000000200000000002
200000000000200000000002
200022220000200222222202
200020020000200000002202
200020022000000000002202
200020002222200000002202
200020000000000000002202
202222222222222222222222
